аа	[RUS NOUN MASC SING NOM]
аб	[RUS NOUN MASC SING GEN]
Ёф	[RUS NOUN MASC SING GEN2]
ав	[RUS NOUN MASC SING DAT]
аг	[RUS NOUN MASC SING ACC]
ад	[RUS NOUN MASC SING INS]
ае	[RUS NOUN MASC SING PREP]
Ёх	[RUS NOUN MASC SING PREP2]
ас	[RUS NOUN MASC SING VOC]
аж	[RUS NOUN MASC PLUR NOM]
аз	[RUS NOUN MASC PLUR GEN]
аи	[RUS NOUN MASC PLUR DAT]
ай	[RUS NOUN MASC PLUR ACC]
ак	[RUS NOUN MASC PLUR INS]
ал	[RUS NOUN MASC PLUR PREP]
ам	[RUS NOUN MASC INVAR]
ан	[RUS NOUN MASC SING INVAR]
ёо	[RUS NOUN SPK MASC SING NOM]
ёп	[RUS NOUN SPK MASC SING GEN]
ёр	[RUS NOUN SPK MASC SING DAT]
ёс	[RUS NOUN SPK MASC SING ACC]
ёт	[RUS NOUN SPK MASC SING INS]
ёф	[RUS NOUN SPK MASC SING PREP]
ёх	[RUS NOUN SPK MASC SING VOC]
яб	[RUS NOUN SPK MASC PLUR NOM]
яа	[RUS NOUN SPK MASC PLUR GEN]
яв	[RUS NOUN SPK MASC PLUR DAT]
яг	[RUS NOUN SPK MASC PLUR ACC]
яд	[RUS NOUN SPK MASC PLUR INS]
яж	[RUS NOUN SPK MASC PLUR PREP]
го	[RUS NOUN ARC MASC SING NOM]
гп	[RUS NOUN ARC MASC SING GEN]
гр	[RUS NOUN ARC MASC SING DAT]
гс	[RUS NOUN ARC MASC SING ACC]
гт	[RUS NOUN ARC MASC SING INS]
гу	[RUS NOUN ARC MASC SING PREP]
гф	[RUS NOUN ARC MASC PLUR NOM]
гх	[RUS NOUN ARC MASC PLUR GEN]
гц	[RUS NOUN ARC MASC PLUR DAT]
гч	[RUS NOUN ARC MASC PLUR ACC]
гш	[RUS NOUN ARC MASC PLUR INS]
гщ	[RUS NOUN ARC MASC PLUR PREP]
ва	[RUS NOUN GCOM SING NOM]
вб	[RUS NOUN GCOM SING GEN]
вв	[RUS NOUN GCOM SING DAT]
вг	[RUS NOUN GCOM SING ACC]
вд	[RUS NOUN GCOM SING INS]
ве	[RUS NOUN GCOM SING PREP]
вж	[RUS NOUN GCOM PLUR NOM]
вз	[RUS NOUN GCOM PLUR GEN]
ви	[RUS NOUN GCOM PLUR DAT]
вй	[RUS NOUN GCOM PLUR ACC]
вк	[RUS NOUN GCOM PLUR INS]
вл	[RUS NOUN GCOM PLUR PREP]
вм	[RUS NOUN GCOM INVAR]
вн	[RUS NOUN GCOM SING INVAR]
во	[RUS NOUN ARC GCOM SING NOM]
вп	[RUS NOUN ARC GCOM SING GEN]
вр	[RUS NOUN ARC GCOM SING DAT]
вс	[RUS NOUN ARC GCOM SING ACC]
вт	[RUS NOUN ARC GCOM SING INS]
ву	[RUS NOUN ARC GCOM SING PREP]
вф	[RUS NOUN ARC GCOM PLUR NOM]
вх	[RUS NOUN ARC GCOM PLUR GEN]
вц	[RUS NOUN ARC GCOM PLUR DAT]
вч	[RUS NOUN ARC GCOM PLUR ACC]
вш	[RUS NOUN ARC GCOM PLUR INS]
вщ	[RUS NOUN ARC GCOM PLUR PREP]
га	[RUS NOUN FEM SING NOM]
гб	[RUS NOUN FEM SING GEN]
гв	[RUS NOUN FEM SING DAT]
гг	[RUS NOUN FEM SING ACC]
гд	[RUS NOUN FEM SING INS]
ге	[RUS NOUN FEM SING PREP]
Ёч	[RUS NOUN FEM SING PREP2]
…ш	[RUS NOUN FEM SING VOC]
гж	[RUS NOUN FEM PLUR NOM]
гз	[RUS NOUN FEM PLUR GEN]
ги	[RUS NOUN FEM PLUR DAT]
гй	[RUS NOUN FEM PLUR ACC]
гк	[RUS NOUN FEM PLUR INS]
гл	[RUS NOUN FEM PLUR PREP]
гм	[RUS NOUN FEM INVAR]
гн	[RUS NOUN FEM SING INVAR]
…а	[RUS NOUN ARC FEM SING NOM]
…б	[RUS NOUN ARC FEM SING GEN]
…в	[RUS NOUN ARC FEM SING DAT]
…г	[RUS NOUN ARC FEM SING ACC]
…д	[RUS NOUN ARC FEM SING INS]
…е	[RUS NOUN ARC FEM SING PREP]
…ж	[RUS NOUN ARC FEM PLUR NOM]
…з	[RUS NOUN ARC FEM PLUR GEN]
…и	[RUS NOUN ARC FEM PLUR DAT]
…й	[RUS NOUN ARC FEM PLUR ACC]
…к	[RUS NOUN ARC FEM PLUR INS]
…л	[RUS NOUN ARC FEM PLUR PREP]
…м	[RUS NOUN SPK FEM SING NOM]
…н	[RUS NOUN SPK FEM SING GEN]
…о	[RUS NOUN SPK FEM SING DAT]
…п	[RUS NOUN SPK FEM SING ACC]
…р	[RUS NOUN SPK FEM SING INS]
…с	[RUS NOUN SPK FEM SING PREP]
…т	[RUS NOUN SPK FEM PLUR NOM]
…у	[RUS NOUN SPK FEM PLUR GEN]
…ф	[RUS NOUN SPK FEM PLUR DAT]
…х	[RUS NOUN SPK FEM PLUR ACC]
…ц	[RUS NOUN SPK FEM PLUR INS]
…ч	[RUS NOUN SPK FEM PLUR PREP]
еа	[RUS NOUN NEU SING NOM]
еб	[RUS NOUN NEU SING GEN]
ев	[RUS NOUN NEU SING DAT]
ег	[RUS NOUN NEU SING ACC]
ед	[RUS NOUN NEU SING INS]
ее	[RUS NOUN NEU SING PREP]
еж	[RUS NOUN NEU PLUR NOM]
ез	[RUS NOUN NEU PLUR GEN]
еи	[RUS NOUN NEU PLUR DAT]
ей	[RUS NOUN NEU PLUR ACC]
ек	[RUS NOUN NEU PLUR INS]
ел	[RUS NOUN NEU PLUR PREP]
ем	[RUS NOUN NEU INVAR]
ен	[RUS NOUN NEU SING INVAR]
Ё€	[RUS NOUN NEU SING GEN ABBR]
яз	[RUS NOUN SPK NEU SING NOM]
яи	[RUS NOUN SPK NEU SING GEN]
як	[RUS NOUN SPK NEU SING DAT]
ял	[RUS NOUN SPK NEU SING ACC]
ям	[RUS NOUN SPK NEU SING INS]
ян	[RUS NOUN SPK NEU SING PREP]
яо	[RUS NOUN SPK NEU PLUR NOM]
яп	[RUS NOUN SPK NEU PLUR GEN]
яр	[RUS NOUN SPK NEU PLUR DAT]
яс	[RUS NOUN SPK NEU PLUR ACC]
ят	[RUS NOUN SPK NEU PLUR INS]
яу	[RUS NOUN SPK NEU PLUR PREP]
иж	[RUS NOUN PLURT NOM]
из	[RUS NOUN PLURT GEN]
ии	[RUS NOUN PLURT DAT]
ий	[RUS NOUN PLURT ACC]
ик	[RUS NOUN PLURT INS]
ил	[RUS NOUN PLURT PREP]
им	[RUS NOUN PLUR INVAR]
ао	[RUS NOUN MASC INVAR ABBR]
ап	[RUS NOUN MASC SING INVAR ABBR]
ат	[RUS NOUN FEM INVAR ABBR]
ау	[RUS NOUN FEM SING INVAR ABBR]
ац	[RUS NOUN NEU INVAR ABBR]
ач	[RUS NOUN NEU SING INVAR ABBR]
аъ	[RUS NOUN PLUR INVAR ABBR]
бо	[RUS NOUN MASC SING NOM FAMN]
бп	[RUS NOUN MASC SING GEN FAMN]
бр	[RUS NOUN MASC SING DAT FAMN]
бс	[RUS NOUN MASC SING ACC FAMN]
бт	[RUS NOUN MASC SING INS FAMN]
бу	[RUS NOUN MASC SING PREP FAMN]
бь	[RUS NOUN SPK MASC SING VOC FAMN]
бф	[RUS NOUN MASC PLUR NOM FAMN]
бх	[RUS NOUN MASC PLUR GEN FAMN]
бц	[RUS NOUN MASC PLUR DAT FAMN]
бч	[RUS NOUN MASC PLUR ACC FAMN]
бш	[RUS NOUN MASC PLUR INS FAMN]
бщ	[RUS NOUN MASC PLUR PREP FAMN]
бЌ	[RUS NOUN MASC INVAR FAMN]
вЌ	[RUS NOUN GCOM INVAR FAMN]
вќ	[RUS NOUN GCOM SING NOM FAMN]
вѕ	[RUS NOUN GCOM SING GEN FAMN]
в–	[RUS NOUN GCOM SING DAT FAMN]
в—	[RUS NOUN GCOM SING ACC FAMN]
в“	[RUS NOUN GCOM SING INS FAMN]
в”	[RUS NOUN GCOM SING PREP FAMN]
в№	[RUS NOUN SPK GCOM SING VOC FAMN]
в‘	[RUS NOUN GCOM PLUR NOM FAMN]
в’	[RUS NOUN GCOM PLUR GEN FAMN]
в÷	[RUS NOUN GCOM PLUR DAT FAMN]
в„	[RUS NOUN GCOM PLUR ACC FAMN]
вЎ	[RUS NOUN GCOM PLUR INS FAMN]
вў	[RUS NOUN GCOM PLUR PREP FAMN]
до	[RUS NOUN FEM SING NOM FAMN]
дп	[RUS NOUN FEM SING GEN FAMN]
др	[RUS NOUN FEM SING DAT FAMN]
дс	[RUS NOUN FEM SING ACC FAMN]
дт	[RUS NOUN FEM SING INS FAMN]
ду	[RUS NOUN FEM SING PREP FAMN]
дь	[RUS NOUN SPK FEM SING VOC FAMN]
дф	[RUS NOUN FEM PLUR NOM FAMN]
дх	[RUS NOUN FEM PLUR GEN FAMN]
дц	[RUS NOUN FEM PLUR DAT FAMN]
дч	[RUS NOUN FEM PLUR ACC FAMN]
дш	[RUS NOUN FEM PLUR INS FAMN]
дщ	[RUS NOUN FEM PLUR PREP FAMN]
дЌ	[RUS NOUN FEM INVAR FAMN]
–а	[RUS NOUN MASC SING NOM PATRN]
–б	[RUS NOUN MASC SING GEN PATRN]
–в	[RUS NOUN MASC SING DAT PATRN]
–г	[RUS NOUN MASC SING ACC PATRN]
–д	[RUS NOUN MASC SING INS PATRN]
–е	[RUS NOUN MASC SING PREP PATRN]
–н	[RUS NOUN MASC PLUR NOM PATRN]
–о	[RUS NOUN MASC PLUR GEN PATRN]
–п	[RUS NOUN MASC PLUR DAT PATRN]
–р	[RUS NOUN MASC PLUR ACC PATRN]
–с	[RUS NOUN MASC PLUR INS PATRN]
–т	[RUS NOUN MASC PLUR PREP PATRN]
–ж	[RUS NOUN FEM SING NOM PATRN]
–з	[RUS NOUN FEM SING GEN PATRN]
–и	[RUS NOUN FEM SING DAT PATRN]
–к	[RUS NOUN FEM SING ACC PATRN]
–л	[RUS NOUN FEM SING INS PATRN]
–м	[RUS NOUN FEM SING PREP PATRN]
–у	[RUS NOUN FEM PLUR NOM PATRN]
–ф	[RUS NOUN FEM PLUR GEN PATRN]
–х	[RUS NOUN FEM PLUR DAT PATRN]
–ц	[RUS NOUN FEM PLUR ACC PATRN]
–ч	[RUS NOUN FEM PLUR INS PATRN]
–ш	[RUS NOUN FEM PLUR PREP PATRN]
“а	[RUS NOUN SPK MASC SING NOM PATRN]
“б	[RUS NOUN SPK MASC SING GEN PATRN]
“в	[RUS NOUN SPK MASC SING DAT PATRN]
“г	[RUS NOUN SPK MASC SING ACC PATRN]
“д	[RUS NOUN SPK MASC SING INS PATRN]
“е	[RUS NOUN SPK MASC SING PREP PATRN]
“н	[RUS NOUN SPK MASC PLUR NOM PATRN]
“о	[RUS NOUN SPK MASC PLUR GEN PATRN]
“п	[RUS NOUN SPK MASC PLUR DAT PATRN]
“р	[RUS NOUN SPK MASC PLUR ACC PATRN]
“с	[RUS NOUN SPK MASC PLUR INS PATRN]
“т	[RUS NOUN SPK MASC PLUR PREP PATRN]
“ж	[RUS NOUN SPK FEM SING NOM PATRN]
“з	[RUS NOUN SPK FEM SING GEN PATRN]
“и	[RUS NOUN SPK FEM SING DAT PATRN]
“к	[RUS NOUN SPK FEM SING ACC PATRN]
“л	[RUS NOUN SPK FEM SING INS PATRN]
“м	[RUS NOUN SPK FEM SING PREP PATRN]
“у	[RUS NOUN SPK FEM PLUR NOM PATRN]
“ф	[RUS NOUN SPK FEM PLUR GEN PATRN]
“х	[RUS NOUN SPK FEM PLUR DAT PATRN]
“ц	[RUS NOUN SPK FEM PLUR ACC PATRN]
“ч	[RUS NOUN SPK FEM PLUR INS PATRN]
“ш	[RUS NOUN SPK FEM PLUR PREP PATRN]
йа	[RUS ADJ MASC SING NOM]
йб	[RUS ADJ MASC SING GEN]
йв	[RUS ADJ MASC SING DAT]
йг	[RUS ADJ MASC SING ACC ANIM]
–щ	[RUS ADJ MASC SING ACC INANIM]
йд	[RUS ADJ MASC SING INS]
йе	[RUS ADJ MASC SING PREP]
йж	[RUS ADJ FEM SING NOM]
йз	[RUS ADJ FEM SING GEN]
йи	[RUS ADJ FEM SING DAT]
йй	[RUS ADJ FEM SING ACC]
йк	[RUS ADJ FEM SING INS]
йл	[RUS ADJ FEM SING PREP]
йм	[RUS ADJ NEU SING NOM]
йн	[RUS ADJ NEU SING GEN]
йо	[RUS ADJ NEU SING DAT]
йп	[RUS ADJ NEU SING ACC]
йр	[RUS ADJ NEU SING INS]
йс	[RUS ADJ NEU SING PREP]
йт	[RUS ADJ PLUR NOM]
йу	[RUS ADJ PLUR GEN]
йф	[RUS ADJ PLUR DAT]
йх	[RUS ADJ PLUR ACC ANIM]
–ь	[RUS ADJ PLUR ACC INANIM]
йц	[RUS ADJ PLUR INS]
йч	[RUS ADJ PLUR PREP]
йш	[RUS ADJ MASC SING BREV]
йщ	[RUS ADJ FEM SING BREV]
йы	[RUS ADJ NEU SING BREV]
йэ	[RUS ADJ PLUR BREV]
йю	[RUS ADJ COMP]
йъ	[RUS ADJ COMP2]
йь	[RUS ADJ SPK COMP]
й€	[RUS ADJ INVAR]
иа	[RUS ADJ MASC SING NOM SUPR]
иб	[RUS ADJ MASC SING GEN SUPR]
ив	[RUS ADJ MASC SING DAT SUPR]
иг	[RUS ADJ MASC SING ACC ANIM SUPR]
ид	[RUS ADJ MASC SING ACC INANIM SUPR]
ие	[RUS ADJ MASC SING INS SUPR]
√б	[RUS ADJ MASC SING PREP SUPR]
√в	[RUS ADJ FEM SING NOM SUPR]
√г	[RUS ADJ FEM SING GEN SUPR]
√д	[RUS ADJ FEM SING DAT SUPR]
√е	[RUS ADJ FEM SING ACC SUPR]
√ж	[RUS ADJ FEM SING INS SUPR]
√з	[RUS ADJ FEM SING PREP SUPR]
ин	[RUS ADJ NEU SING NOM SUPR]
ио	[RUS ADJ NEU SING GEN SUPR]
ип	[RUS ADJ NEU SING DAT SUPR]
ир	[RUS ADJ NEU SING ACC SUPR]
ис	[RUS ADJ NEU SING INS SUPR]
ит	[RUS ADJ NEU SING PREP SUPR]
иу	[RUS ADJ PLUR NOM SUPR]
иф	[RUS ADJ PLUR GEN SUPR]
их	[RUS ADJ PLUR DAT SUPR]
иц	[RUS ADJ PLUR ACC ANIM SUPR]
ич	[RUS ADJ PLUR ACC INANIM SUPR]
иш	[RUS ADJ PLUR INS SUPR]
ищ	[RUS ADJ PLUR PREP SUPR]
нр	[RUS AVALENT INF]
нс	[RUS VERB FUTU AVALENT]
нт	[RUS VERB PAST AVALENT]
ну	[RUS VERB PRES AVALENT]
ка	[RUS INF ACT]
кб	[RUS VERB SING PRES P1 ACT]
кв	[RUS VERB PLUR PRES P1 ACT]
кг	[RUS VERB SING PRES P2 ACT]
кд	[RUS VERB PLUR PRES P2 ACT]
ке	[RUS VERB SING PRES P3 ACT]
кж	[RUS VERB PLUR PRES P3 ACT]
кз	[RUS VERB MASC SING PAST ACT]
ки	[RUS VERB FEM SING PAST ACT]
кй	[RUS VERB NEU SING PAST ACT]
кк	[RUS VERB PLUR PAST ACT]
кп	[RUS VERB SING FUTU P1 ACT]
кр	[RUS VERB PLUR FUTU P1 ACT]
кс	[RUS VERB SING FUTU P2 ACT]
кт	[RUS VERB PLUR FUTU P2 ACT]
ку	[RUS VERB SING FUTU P3 ACT]
кф	[RUS VERB PLUR FUTU P3 ACT]
–ъ	[RUS VERB SPK SING PRES P1 ACT]
–ы	[RUS VERB SPK PLUR PRES P1 ACT]
–э	[RUS VERB SPK SING PRES P2 ACT]
–ю	[RUS VERB SPK PLUR PRES P2 ACT]
–€	[RUS VERB SPK SING PRES P3 ACT]
кю	[RUS VERB SPK PLUR PRES P3 ACT]
к€	[RUS VERB SPK PLUR PAST ACT]
кэ	[RUS VERB SPK SING FUTU P1 ACT]
Ёа	[RUS VERB SPK PLUR FUTU P1 ACT]
Ёб	[RUS VERB SPK SING FUTU P2 ACT]
Ёв	[RUS VERB SPK PLUR FUTU P2 ACT]
Ёг	[RUS VERB SPK SING FUTU P3 ACT]
Ёд	[RUS VERB SPK PLUR FUTU P3 ACT]
Ёе	[RUS VERB ARC SING PRES P1 ACT]
Ёж	[RUS VERB ARC PLUR PRES P1 ACT]
Ёз	[RUS VERB ARC SING PRES P2 ACT]
Ёи	[RUS VERB ARC PLUR PRES P2 ACT]
Ёй	[RUS VERB ARC SING PRES P3 ACT]
Ёк	[RUS VERB ARC PLUR PRES P3 ACT]
Ёл	[RUS VERB ARC PLUR PAST ACT]
Ём	[RUS VERB ARC SING FUTU P1 ACT]
Ён	[RUS VERB ARC PLUR FUTU P1 ACT]
Ёо	[RUS VERB ARC SING FUTU P2 ACT]
Ёп	[RUS VERB ARC PLUR FUTU P2 ACT]
Ёр	[RUS VERB ARC SING FUTU P3 ACT]
Ёс	[RUS VERB ARC PLUR FUTU P3 ACT]
кн	[RUS GPARTCP PRES ACT]
ко	[RUS GPARTCP PAST ACT]
Ёт	[RUS GPARTCP ARC PRES ACT]
Ёу	[RUS GPARTCP ARC PAST ACT]
нп	[RUS VERB PLUR P1 IMPERV ACT]
къ	[RUS VERB SING P1 IMPERV ACT]
кл	[RUS VERB SING P2 IMPERV ACT]
км	[RUS VERB PLUR P2 IMPERV ACT]
ль	[RUS VERB SPK SING P2 IMPERV ACT]
кь	[RUS VERB SPK PLUR P2 IMPERV ACT]
Ёю	[RUS VERB SING P2 IMPERV ACT ABBR]
фъ	[RUS VERB ARC SING P2 IMPERV ACT]
фю	[RUS VERB ARC PLUR P2 IMPERV ACT]
ла	[RUS PARTCP MASC SING NOM PRES ACT]
лб	[RUS PARTCP MASC SING GEN PRES ACT]
лв	[RUS PARTCP MASC SING DAT PRES ACT]
лг	[RUS PARTCP MASC SING ACC PRES ANIM ACT]
Ћа	[RUS PARTCP MASC SING ACC PRES INANIM ACT]
лд	[RUS PARTCP MASC SING INS PRES ACT]
ле	[RUS PARTCP MASC SING PREP PRES ACT]
лз	[RUS PARTCP FEM SING NOM PRES ACT]
ли	[RUS PARTCP FEM SING GEN PRES ACT]
лй	[RUS PARTCP FEM SING DAT PRES ACT]
лк	[RUS PARTCP FEM SING ACC PRES ACT]
лл	[RUS PARTCP FEM SING INS PRES ACT]
лм	[RUS PARTCP FEM SING PREP PRES ACT]
ло	[RUS PARTCP NEU SING NOM PRES ACT]
лп	[RUS PARTCP NEU SING GEN PRES ACT]
лр	[RUS PARTCP NEU SING DAT PRES ACT]
лс	[RUS PARTCP NEU SING ACC PRES ACT]
лт	[RUS PARTCP NEU SING INS PRES ACT]
лу	[RUS PARTCP NEU SING PREP PRES ACT]
лх	[RUS PARTCP PLUR NOM PRES ACT]
лц	[RUS PARTCP PLUR GEN PRES ACT]
лч	[RUS PARTCP PLUR DAT PRES ACT]
лш	[RUS PARTCP PLUR ACC PRES ANIM ACT]
Ћй	[RUS PARTCP PLUR ACC PRES INANIM ACT]
лщ	[RUS PARTCP PLUR INS PRES ACT]
лы	[RUS PARTCP PLUR PREP PRES ACT]
ма	[RUS PARTCP MASC SING NOM PAST ACT]
мб	[RUS PARTCP MASC SING GEN PAST ACT]
мв	[RUS PARTCP MASC SING DAT PAST ACT]
мг	[RUS PARTCP MASC SING ACC PAST ANIM ACT]
Ћб	[RUS PARTCP MASC SING ACC PAST INANIM ACT]
мд	[RUS PARTCP MASC SING INS PAST ACT]
ме	[RUS PARTCP MASC SING PREP PAST ACT]
мз	[RUS PARTCP FEM SING NOM PAST ACT]
ми	[RUS PARTCP FEM SING GEN PAST ACT]
мй	[RUS PARTCP FEM SING DAT PAST ACT]
мк	[RUS PARTCP FEM SING ACC PAST ACT]
мл	[RUS PARTCP FEM SING INS PAST ACT]
мм	[RUS PARTCP FEM SING PREP PAST ACT]
мо	[RUS PARTCP NEU SING NOM PAST ACT]
мп	[RUS PARTCP NEU SING GEN PAST ACT]
мр	[RUS PARTCP NEU SING DAT PAST ACT]
мс	[RUS PARTCP NEU SING ACC PAST ACT]
мт	[RUS PARTCP NEU SING INS PAST ACT]
му	[RUS PARTCP NEU SING PREP PAST ACT]
мх	[RUS PARTCP PLUR NOM PAST ACT]
мц	[RUS PARTCP PLUR GEN PAST ACT]
мч	[RUS PARTCP PLUR DAT PAST ACT]
мш	[RUS PARTCP PLUR ACC PAST ANIM ACT]
Ћк	[RUS PARTCP PLUR ACC PAST INANIM ACT]
мщ	[RUS PARTCP PLUR INS PAST ACT]
мы	[RUS PARTCP PLUR PREP PAST ACT]
па	[RUS PARTCP MASC SING NOM PRES PASS]
пб	[RUS PARTCP MASC SING GEN PRES PASS]
пв	[RUS PARTCP MASC SING DAT PRES PASS]
пг	[RUS PARTCP MASC SING ACC PRES ANIM PASS]
Ћг	[RUS PARTCP MASC SING ACC PRES INANIM PASS]
пд	[RUS PARTCP MASC SING INS PRES PASS]
пе	[RUS PARTCP MASC SING PREP PRES PASS]
пж	[RUS PARTCP MASC SING PRES PASS BREV]
пз	[RUS PARTCP FEM SING NOM PRES PASS]
пи	[RUS PARTCP FEM SING GEN PRES PASS]
пй	[RUS PARTCP FEM SING DAT PRES PASS]
пк	[RUS PARTCP FEM SING ACC PRES PASS]
пл	[RUS PARTCP FEM SING INS PRES PASS]
пм	[RUS PARTCP FEM SING PREP PRES PASS]
пн	[RUS PARTCP FEM SING PRES PASS BREV]
по	[RUS PARTCP NEU SING NOM PRES PASS]
пп	[RUS PARTCP NEU SING GEN PRES PASS]
пр	[RUS PARTCP NEU SING DAT PRES PASS]
пс	[RUS PARTCP NEU SING ACC PRES PASS]
пт	[RUS PARTCP NEU SING INS PRES PASS]
пу	[RUS PARTCP NEU SING PREP PRES PASS]
пф	[RUS PARTCP NEU SING PRES PASS BREV]
пх	[RUS PARTCP PLUR NOM PRES PASS]
пц	[RUS PARTCP PLUR GEN PRES PASS]
пч	[RUS PARTCP PLUR DAT PRES PASS]
пш	[RUS PARTCP PLUR ACC PRES ANIM PASS]
Ћм	[RUS PARTCP PLUR ACC PRES INANIM PASS]
пщ	[RUS PARTCP PLUR INS PRES PASS]
пы	[RUS PARTCP PLUR PREP PRES PASS]
пэ	[RUS PARTCP PLUR PRES PASS BREV]
са	[RUS PARTCP MASC SING NOM PAST PASS]
сб	[RUS PARTCP MASC SING GEN PAST PASS]
св	[RUS PARTCP MASC SING DAT PAST PASS]
сг	[RUS PARTCP MASC SING ACC PAST ANIM PASS]
Ће	[RUS PARTCP MASC SING ACC PAST INANIM PASS]
сд	[RUS PARTCP MASC SING INS PAST PASS]
се	[RUS PARTCP MASC SING PREP PAST PASS]
сж	[RUS PARTCP MASC SING PAST PASS BREV]
сз	[RUS PARTCP FEM SING NOM PAST PASS]
си	[RUS PARTCP FEM SING GEN PAST PASS]
сй	[RUS PARTCP FEM SING DAT PAST PASS]
ск	[RUS PARTCP FEM SING ACC PAST PASS]
сл	[RUS PARTCP FEM SING INS PAST PASS]
см	[RUS PARTCP FEM SING PREP PAST PASS]
сн	[RUS PARTCP FEM SING PAST PASS BREV]
со	[RUS PARTCP NEU SING NOM PAST PASS]
сп	[RUS PARTCP NEU SING GEN PAST PASS]
ср	[RUS PARTCP NEU SING DAT PAST PASS]
сс	[RUS PARTCP NEU SING ACC PAST PASS]
ст	[RUS PARTCP NEU SING INS PAST PASS]
су	[RUS PARTCP NEU SING PREP PAST PASS]
сф	[RUS PARTCP NEU SING PAST PASS BREV]
сх	[RUS PARTCP PLUR NOM PAST PASS]
сц	[RUS PARTCP PLUR GEN PAST PASS]
сч	[RUS PARTCP PLUR DAT PAST PASS]
сш	[RUS PARTCP PLUR ACC PAST ANIM PASS]
Ћо	[RUS PARTCP PLUR ACC PAST INANIM PASS]
сщ	[RUS PARTCP PLUR INS PAST PASS]
сы	[RUS PARTCP PLUR PREP PAST PASS]
сэ	[RUS PARTCP PLUR PAST PASS BREV]
ча	[RUS PRONOUN SING NOM P1]
чб	[RUS PRONOUN SING GEN P1]
чв	[RUS PRONOUN SING DAT P1]
чг	[RUS PRONOUN SING ACC P1]
чд	[RUS PRONOUN SING INS P1]
че	[RUS PRONOUN SING PREP P1]
чж	[RUS PRONOUN PLUR NOM P1]
чз	[RUS PRONOUN PLUR GEN P1]
чи	[RUS PRONOUN PLUR DAT P1]
чй	[RUS PRONOUN PLUR ACC P1]
чк	[RUS PRONOUN PLUR INS P1]
чл	[RUS PRONOUN PLUR PREP P1]
чм	[RUS PRONOUN SING NOM P2]
чн	[RUS PRONOUN SING GEN P2]
чо	[RUS PRONOUN SING DAT P2]
чп	[RUS PRONOUN SING ACC P2]
чр	[RUS PRONOUN SING INS P2]
чс	[RUS PRONOUN SING PREP P2]
чт	[RUS PRONOUN PLUR NOM P2]
чу	[RUS PRONOUN PLUR GEN P2]
чф	[RUS PRONOUN PLUR DAT P2]
чх	[RUS PRONOUN PLUR ACC P2]
чц	[RUS PRONOUN PLUR INS P2]
чч	[RUS PRONOUN PLUR PREP P2]
ша	[RUS PRONOUN MASC SING NOM P3]
шб	[RUS PRONOUN MASC SING GEN P3]
шв	[RUS PRONOUN MASC SING DAT P3]
шг	[RUS PRONOUN MASC SING ACC P3]
шд	[RUS PRONOUN MASC SING INS P3]
ше	[RUS PRONOUN MASC SING PREP P3]
шж	[RUS PRONOUN FEM SING NOM P3]
шз	[RUS PRONOUN FEM SING GEN P3]
ши	[RUS PRONOUN FEM SING DAT P3]
шй	[RUS PRONOUN FEM SING ACC P3]
шк	[RUS PRONOUN FEM SING INS P3]
шл	[RUS PRONOUN FEM SING PREP P3]
шм	[RUS PRONOUN NEU SING NOM P3]
шн	[RUS PRONOUN NEU SING GEN P3]
шо	[RUS PRONOUN NEU SING DAT P3]
шп	[RUS PRONOUN NEU SING ACC P3]
шр	[RUS PRONOUN NEU SING INS P3]
шс	[RUS PRONOUN NEU SING PREP P3]
шт	[RUS PRONOUN PLUR NOM P3]
шу	[RUS PRONOUN PLUR GEN P3]
шф	[RUS PRONOUN PLUR DAT P3]
шх	[RUS PRONOUN PLUR ACC P3]
шц	[RUS PRONOUN PLUR INS P3]
шч	[RUS PRONOUN PLUR PREP P3]
ща	[RUS PRONOUN MASC SING NOM]
щб	[RUS PRONOUN MASC SING GEN]
щв	[RUS PRONOUN MASC SING DAT]
щг	[RUS PRONOUN MASC SING ACC]
щд	[RUS PRONOUN MASC SING INS]
ще	[RUS PRONOUN MASC SING PREP]
щж	[RUS PRONOUN FEM SING NOM]
щз	[RUS PRONOUN FEM SING GEN]
щи	[RUS PRONOUN FEM SING DAT]
щй	[RUS PRONOUN FEM SING ACC]
щк	[RUS PRONOUN FEM SING INS]
щл	[RUS PRONOUN FEM SING PREP]
щм	[RUS PRONOUN NEU SING NOM]
щн	[RUS PRONOUN NEU SING GEN]
що	[RUS PRONOUN NEU SING DAT]
щп	[RUS PRONOUN NEU SING ACC]
щр	[RUS PRONOUN NEU SING INS]
щс	[RUS PRONOUN NEU SING PREP]
щт	[RUS PRONOUN PLUR NOM]
щу	[RUS PRONOUN PLUR GEN]
щф	[RUS PRONOUN PLUR DAT]
щх	[RUS PRONOUN PLUR ACC]
щц	[RUS PRONOUN PLUR INS]
щч	[RUS PRONOUN PLUR PREP]
щщ	[RUS PRONOUN GEN]
щы	[RUS PRONOUN DAT]
щэ	[RUS PRONOUN ACC]
щю	[RUS PRONOUN INS]
щ€	[RUS PRONOUN PREP]
ыа	[RUS PRONOUNPOSS MASC SING NOM]
ыб	[RUS PRONOUNPOSS MASC SING GEN]
ыв	[RUS PRONOUNPOSS MASC SING DAT]
ыг	[RUS PRONOUNPOSS MASC SING ACC INANIM]
Ћф	[RUS PRONOUNPOSS MASC SING ACC ANIM]
ыд	[RUS PRONOUNPOSS MASC SING INS]
ые	[RUS PRONOUNPOSS MASC SING PREP]
ыж	[RUS PRONOUNPOSS FEM SING NOM]
ыз	[RUS PRONOUNPOSS FEM SING GEN]
ыи	[RUS PRONOUNPOSS FEM SING DAT]
ый	[RUS PRONOUNPOSS FEM SING ACC]
ык	[RUS PRONOUNPOSS FEM SING INS]
ыл	[RUS PRONOUNPOSS FEM SING PREP]
ым	[RUS PRONOUNPOSS NEU SING NOM]
ын	[RUS PRONOUNPOSS NEU SING GEN]
ыо	[RUS PRONOUNPOSS NEU SING DAT]
ып	[RUS PRONOUNPOSS NEU SING ACC]
ыр	[RUS PRONOUNPOSS NEU SING INS]
ыс	[RUS PRONOUNPOSS NEU SING PREP]
ыт	[RUS PRONOUNPOSS PLUR NOM]
ыу	[RUS PRONOUNPOSS PLUR GEN]
ыф	[RUS PRONOUNPOSS PLUR DAT]
ых	[RUS PRONOUNPOSS PLUR ACC INANIM]
Ћх	[RUS PRONOUNPOSS PLUR ACC ANIM]
ыц	[RUS PRONOUNPOSS PLUR INS]
ыч	[RUS PRONOUNPOSS PLUR PREP]
ыш	[RUS PRONOUNPOSS INVAR]
ыщ	[RUS PRAEDICPRO SING GEN]
ыы	[RUS PRAEDICPRO SING DAT]
ыэ	[RUS PRAEDICPRO SING ACC]
ыю	[RUS PRAEDICPRO SING INS]
ыь	[RUS PRAEDICPRO SING PREP]
ы€	[RUS PRAEDICPRO]
эа	[RUS NUM NOM]
эб	[RUS NUM GEN]
эв	[RUS NUM DAT]
эг	[RUS NUM ACC]
эд	[RUS NUM INS]
эе	[RUS NUM PREP]
÷а	[RUS NUM ARC NOM]
÷б	[RUS NUM ARC GEN]
÷в	[RUS NUM ARC DAT]
÷г	[RUS NUM ARC ACC]
÷д	[RUS NUM ARC INS]
÷е	[RUS NUM ARC PREP]
эж	[RUS NUM MASC NOM]
эз	[RUS NUM MASC GEN]
эи	[RUS NUM MASC DAT]
эй	[RUS NUM MASC ACC]
эк	[RUS NUM MASC INS]
эл	[RUS NUM MASC PREP]
эм	[RUS NUM FEM NOM]
эн	[RUS NUM FEM GEN]
эо	[RUS NUM FEM DAT]
эп	[RUS NUM FEM ACC]
эр	[RUS NUM FEM INS]
эс	[RUS NUM FEM PREP]
эт	[RUS NUM NEU NOM]
эу	[RUS NUM NEU GEN]
эф	[RUS NUM NEU DAT]
эх	[RUS NUM NEU ACC]
эц	[RUS NUM NEU INS]
эч	[RUS NUM NEU PREP]
эш	[RUS NUM COMP]
юа	[RUS ORD MASC SING NOM]
юб	[RUS ORD MASC SING GEN]
юв	[RUS ORD MASC SING DAT]
юг	[RUS ORD MASC SING ACC INANIM]
Ћт	[RUS ORD MASC SING ACC ANIM]
юд	[RUS ORD MASC SING INS]
юе	[RUS ORD MASC SING PREP]
юж	[RUS ORD FEM SING NOM]
юз	[RUS ORD FEM SING GEN]
юи	[RUS ORD FEM SING DAT]
юй	[RUS ORD FEM SING ACC]
юк	[RUS ORD FEM SING INS]
юл	[RUS ORD FEM SING PREP]
юм	[RUS ORD NEU SING NOM]
юн	[RUS ORD NEU SING GEN]
юо	[RUS ORD NEU SING DAT]
юп	[RUS ORD NEU SING ACC]
юр	[RUS ORD NEU SING INS]
юс	[RUS ORD NEU SING PREP]
ют	[RUS ORD PLUR NOM]
юу	[RUS ORD PLUR GEN]
юф	[RUS ORD PLUR DAT]
юх	[RUS ORD PLUR ACC INANIM]
Ћу	[RUS ORD PLUR ACC ANIM]
юц	[RUS ORD PLUR INS]
юч	[RUS ORD PLUR PREP]
ющ	[RUS ORD GEN]
€а	[RUS ADVERB]
€н	[RUS ADVERB ADVINTR]
€о	[RUS ADVERB ADVPNT]
€п	[RUS ADVERB SPK]
€б	[RUS PRAEDIC PRES]
€к	[RUS PRAEDIC PAST]
€л	[RUS PRAEDIC]
€р	[RUS PRAEDIC PRES COMP]
€м	[RUS PRAEDIC INVAR]
€в	[RUS PREPOS]
€г	[RUS POSTPOS]
€д	[RUS CONJ]
€е	[RUS INTERJ]
€Є	[RUS INTERJ SPK]
€ж	[RUS PART]
€з	[RUS PARENTH]
€й	[RUS PHRAS]
ѕп	[RUS VERB SING FUTU P1 PASS]
ѕр	[RUS VERB PLUR FUTU P1 PASS]
ѕс	[RUS VERB SING FUTU P2 PASS]
ѕт	[RUS VERB PLUR FUTU P2 PASS]
ѕу	[RUS VERB SING FUTU P3 PASS]
ѕф	[RUS VERB PLUR FUTU P3 PASS]
”а	[RUS LOC]
”е	[RUS ADJQUAL]
”ж	[RUS SINGT]
”з	[RUS SINGT ORG]
”и	[RUS SINGT LOC]
”л	[RUS TRANS PERFV]
”м	[RUS INTRANS PERFV]
”н	[RUS TRANS IMPERFV]
”о	[RUS INTRANS IMPERFV]
”п	[RUS TRANS IMPERFV]
”р	[RUS INTRANS IMPERFV]
”с	[RUS IMPERFV]
”т	[RUS PERFV]
”ф	[RUS VUL]
”х	[RUS ERR]
”ч	[RUS VUL ERR]
”ц	[RUS VUL ORG]
”ш	[RUS VUL LOC]
”щ	[RUS INANIM LOC]
”ь	[RUS INANIM ORG]
”ы	[RUS ANIM FAMN]
”ъ	[RUS SINGT INANIM LOC]
”э	[RUS SINGT INANIM ORG]
”ю	[RUS VUL INANIM]
”€	[RUS INANIM ERR]
‘а	[RUS INANIM]
‘б	[RUS ANIM]
‘в	[RUS VUL INANIM ORG]
‘г	[RUS SINGT INANIM]
‘д	[RUS SINGT ANIM]
‘ж	[RUS VUL ANIM]
‘з	[RUS ADJPOSS FAMN]
‘и	[RUS ADJPOSS]
‘к	[RUS SPK TRANS PERFV]
‘л	[RUS SPK INTRANS PERFV]
‘н	[RUS SPK TRANS IMPERFV]
‘о	[RUS SPK INTRANS IMPERFV]
‘п	[RUS SPK INANIM]
‘р	[RUS SPK ANIM]
‘с	[RUS VUL TRANS PERFV]
‘т	[RUS VUL INTRANS PERFV]
‘у	[RUS VUL TRANS IMPERFV]
‘ф	[RUS VUL INTRANS IMPERFV]
‘х	[RUS SPK]
‘ц	[RUS ARC]
‘ч	[RUS ARC TRANS PERFV]
‘ш	[RUS ARC INTRANS PERFV]
‘щ	[RUS ARC TRANS IMPERFV]
‘ь	[RUS ARC INTRANS IMPERFV]
‘ы	[RUS ARC INANIM]
‘ъ	[RUS ARC ANIM]
‘э	[RUS ARC IMPERFV]
‘ю	[RUS ARC PERFV]
‘€	[RUS ARC ADJQUAL]
‘Є	[RUS]
’а	[RUS ANIM ERR]
’б	[RUS LOC ERR]
€ю	[RUS NOUN NEU SING PREP]
